####################
#..................#
#.BB###.#BB#B##.##.#
#..#.BB#.##.###.#..#
#.#.B#B##.#.#.##B..#
#.....B##.#.#.#....#
#...B##.B##S#.B#...#
#....#.##B#..B.#...#
#...#BB####.#.B....#
#.#....S##S........#
#.#BBB#.##B.B.####.#
#.##..B.##..#.#.#B.#
#.#.#.#.B.#.#.##B..#
#..................#
####################
