####################
#..................#
#.B.#.###.B.##B.##.#
#..##.#B.##.....S..#
#.#.#########.B##..#
#.....#.##.###B#...#
#...#.###.###B##...#
#...####B.#S####...#
#...B.###.#.##BS...#
#.##.#....#..#####.#
#.###.###.#.#.#.BB.#
#..#..#..##BB....#.#
#.###.#.#.#SB.##B#.#
#..................#
####################
