####################
#..................#
#.###BB##.BBB#####.#
#.#..B.S..#..#####.#
#.###B#.#.##B##.#..#
#...BB#..#B##.S....#
#...B##.#.###.#B...#
#......#.#######...#
#...#####B####B#...#
#...#.#BS#..#....#.#
#.#.B#B.#BB.###.#..#
#.BB#B..##.BB#...#.#
#.B.######B#BBB.#..#
#..................#
####################
