####################
#..................#
#.###.###B#.B.#SB#.#
#.B##.##S.B######B.#
#.BB#.#.#.#B###.##.#
#......#S...##.....#
#...B.B.#####B##...#
#....##B###..##....#
#...###.#####.##...#
#..B..#B#.B...B....#
#.#B#####.####B###.#
#....#.#.###.B###..#
#.###.#.#B#B###.#..#
#..................#
####################
