####################
#..................#
#....B.............#
#.B....B..B.....B..#
#........B.........#
#....S........S....#
#....#.B#......#...#
#...........BB#....#
#.....B............#
#...........B......#
#....S......BB.S...#
#...BBBB...BB.#.B..#
#............B.....#
#..................#
####################
