####################
#..................#
#.#.B.BBB.B.BS#BB..#
#..#.#.B..#.#.BB.#.#
#.#.B#B.##B.#.B#B..#
#.....#............#
#...B.#B###.BB#....#
#....B.....B.###...#
#...#.#BB.#.#.B#...#
#.#...#B#..#S#..##.#
#.#.B.B.B######.#B.#
#..#..#..B.....#...#
#.#.#.B.B.B##.B.B..#
#..................#
####################
