####################
#..................#
#..................#
#..........S.#.....#
#....BB...B..B.....#
#...BB...B..S..S...#
#......#.......B...#
#..................#
#......B.....#B....#
#.........B........#
#..................#
#....S.........B.B.#
#.B......B..S.BS.B.#
#..................#
####################
