####################
#..................#
#.###.#.#.#####.##.#
#.#B#S#.##.B##BBB#.#
#.B.###.B##.#.#.#..#
#....####.B.BB.....#
#...#.#.#######....#
#.....B.B#.S###....#
#...#.#####.B.##...#
#.#S###.##B.#..#...#
#.#.B.###.#.B.#B##.#
#...B#BB...######S.#
#.#####.B#B.#####..#
#..................#
####################
