####################
#..................#
#.#########.#.###..#
#..#S.##.B#.##B###.#
#.#######.#.##BS##.#
#....#..#..##..#...#
#...#.BB#.#####....#
#...##....##.##....#
#...#BB##.#####B...#
#..###..B##.S.#.##.#
#.#.###S#.#######..#
#.##.####S#.###....#
#.#.#.B.B.#.#.###B.#
#..................#
####################
