####################
#..................#
#.##B.###B###.#.##.#
#..#S.##..###.####.#
#.######B####.####.#
#......#####..##...#
#...#########.##...#
#...B.#.#.#.####...#
#...#.#S#SB##.##...#
#..####.###.#B####.#
#.#.##############.#
#.S###..#.##..####.#
#.#.#####.#####.#S.#
#..................#
####################
