####################
#..................#
#....B.............#
#.B....B..B.....B..#
#........B.........#
#.............B....#
#....#.B#......#...#
#...........BB#....#
#.....B............#
#...........B......#
#...........BB.....#
#...BBBB...BB.#.B..#
#............B.....#
#..................#
####################
