####################
#..................#
#.B##.B#B##.#BB.#..#
#.#B..B.B...B.B.B#.#
#.#.B##.B##.#.B.B#.#
#...#.##.S.B##.....#
#...#S#######.B....#
#...BB#BB..B#.#....#
#...B.#.BBB.###....#
#.......##....B##..#
#.###BB.#BB###B##..#
#.S.#B...#B#.#B.S..#
#.##B###B.##B.#.B..#
#..................#
####################
