####################
#..................#
#.#.###.#.###.#.##.#
#.########B..#####.#
#.#.###.###.#.#.#..#
#....B.#.#...S#....#
#...############...#
#....###..###.##...#
#...#######.####...#
#.#...#..#..######.#
#.#####.#.#####.##.#
#..#######.#..S#.#.#
#.##B.#.###.#####B.#
#..................#
####################
