####################
#..................#
#.#BBB#B#.B.#.#.B#.#
#..S#.BBB.....S.#B.#
#.#.##B#B.#.#.#.B..#
#......#.B.#.#.B...#
#...B.#BB.B.#.##S..#
#....B...#B#...B...#
#..SB.##B.B.#.BB...#
#.....B.B#..##B....#
#.#.B##.##B.B.B.B..#
#.B#...B........##.#
#.#.B##.#.##B##B#S.#
#..S...............#
####################
