####################
#..................#
#.###.############.#
#.###.######....##.#
#.#######.########.#
#...###.##.####S...#
#...#.#####.###....#
#...##S###.#.###...#
#...###.#######....#
#.#.########.###S..#
#.###.############.#
#...##.##.#####S##.#
#.#.#.###.#####.#..#
#..................#
####################
