####################
#............S.....#
#.B.....B......B...#
#...B.........BB...#
#....B#..B......B..#
#..........##...S..#
#.......B......B...#
#...B......B.......#
#..........B#......#
#....S..........#..#
#.#.............B..#
#.B....B....S..B.#.#
#....B...........B.#
#..................#
####################
