####################
#..................#
#.............B....#
#..................#
#..S......B.B..B.#.#
#...B..............#
#............SB....#
#...B.......B......#
#....B.............#
#.B#.......B.BBBB..#
#....B........S..S.#
#....#...........#.#
#.....B....S.B.#.B.#
#..................#
####################
