####################
#..................#
#....B..#..B.B.S.#.#
#.B.#..B#...S......#
#..........#....#..#
#....B...#.#B......#
#....B#.S#BB.......#
#.......#..........#
#...B...BS.........#
#....B......B......#
#......B...#.......#
#.SB...BB.B....#...#
#.......BB.B.#..#..#
#..................#
####################
