####################
#..............S...#
#..................#
#..B...............#
#..B....#....#.BBB.#
#.....B.B...#......#
#......#.#B........#
#..S.......BBB..S..#
#......B.B...B.B...#
#.....B#.#.........#
#....B.B..B.#.B....#
#..B..BB...B..B....#
#...............B#.#
#...S..........S...#
####################
