####################
#..................#
#..................#
#..B...............#
#..B....#....#.BBB.#
#.....B.B...#......#
#......#.#B........#
#..........BBB.....#
#......B.B...B.B...#
#.....B#.#.........#
#....B.B..B.#.B....#
#..B..BB...B..B....#
#...............B#.#
#..................#
####################
