####################
#..................#
#...B.B.B...B#.BB..#
#..................#
#..B....B..##...B..#
#...#.......S......#
#...##..#B..B.B#...#
#..............S...#
#.......B......S...#
#...........B......#
#..B....#...B.#....#
#.......#...#......#
#...#.BBB...BB.B#..#
#..................#
####################
