####################
#..................#
#..#..S.....#B.....#
#..................#
#....#....B..B..#B.#
#..................#
#...B....B.BB......#
#...B...........S..#
#...BB..B#.........#
#...........#......#
#.##...B....#..#B#.#
#.........S........#
#.B..B.#B.....#.B..#
#...S...........S..#
####################
