####################
#..................#
#..#........#B.....#
#..................#
#....#....B..B..#B.#
#..................#
#...B....B.BB......#
#...B..............#
#...BB..B#.........#
#...........#......#
#.##...B....#..#B#.#
#..................#
#.B..B.#B.....#.B..#
#..................#
####################
