####################
#..................#
#...#B.B.B#.B....#.#
#...#...#.....S....#
#.B......B#....#.#.#
#...S..............#
#..........#.......#
#.......B..........#
#...B....B.#.B#....#
#..S....#.......S..#
#....B.BB...BBB.#..#
#...B.......#......#
#.#......#B#BB.S.B.#
#....S.............#
####################
