####################
#..................#
#...#B.B.B#.B....#.#
#...#...#..........#
#.B......B#....#.#.#
#..................#
#..........#.......#
#.......B..........#
#...B....B.#.B#....#
#.......#..........#
#....B.BB...BBB.#..#
#...B.......#......#
#.#......#B#BB...B.#
#..................#
####################
