####################
#..................#
#...B.BBBBB...#....#
#........S.....S...#
#..#.....B#.#.#.B..#
#.........S........#
#...B.#.B.B..B.B...#
#...B.S............#
#...BB.BBB.B.##....#
#.......S...S......#
#..BB....B.B..B..B.#
#..................#
#.B.....B..BBB#..#.#
#..................#
####################
