####################
#..................#
#.#...B..S....#....#
#...........S......#
#....B......#BBB...#
#.......B..........#
#...#..B.##B..BB...#
#...B.......#......#
#.....B#..B.#..B...#
#...#..............#
#.B#.S.B#.B..#.#...#
#...#..............#
#.#....B#..#..#.#..#
#..................#
####################
