####################
#...S..............#
#...B.B.##B##B.....#
#.......B..........#
#.#..B.B...BB...S..#
#.......#..........#
#...B..#BB##..#....#
#...B..............#
#....S...#B..B.....#
#.......B..........#
#..#...##.####..S..#
#..................#
#.B.BB.##..#B..#.#.#
#...S...........S..#
####################
