####################
#....S.............#
#.BBB...B##.....S..#
#...#.......#......#
#.###.##....B#.B...#
#.......#..........#
#...#B#.#B##....S..#
#...#..............#
#...#..#BB##.B.....#
#.....S............#
#.B##...##B..B...#.#
#.......B..........#
#.#B#....#B#BB..S..#
#...S..............#
####################
