####################
#..................#
#.BBS..#BB....B#B..#
#......S...........#
#.#.BBB#BBB.....#..#
#...........#......#
#.....#S.B.BBB.....#
#...B...B..........#
#....#..#B.BB......#
#...B..S...........#
#.#.BBB..BB...#BB..#
#............S.....#
#..##...#.#....B...#
#..................#
####################
