####################
#......S...........#
#.B.BBB.#.#.#B#.B..#
#.#.#.B.#.#...#....#
#.B.B.#.B.B.BBBSB..#
#....BB.#....B.....#
#...#B#.B#B.#.#....#
#...S....#..B#.....#
#...BBB.#.BB#BB#...#
#...B...B..##.S.#..#
#.B.BB#.BB#.B.#.##.#
#.#..BB.......B.BB.#
#.#.#.B.B###B.##BB.#
#..S............S..#
####################
