####################
#..................#
#.B.BBB.#.#.#B#.B..#
#.#.#.B.#.#...#....#
#.B.B.#.B.B.BBB.B..#
#....BB.#....B.....#
#...#B#.B#B.#.#....#
#........#..B#.....#
#...BBB.#.BB#BB#...#
#...B...B..##...#..#
#.B.BB#.BB#.B.#.##.#
#.#..BB.......B.BB.#
#.#.#.B.B###B.##BB.#
#..................#
####################
