####################
#..................#
#.#BB.BS#.#.#BB.#..#
#.....B....#B..#.B.#
#.B.#.B.B.#B#.#B#B.#
#...BB#.B.S.#......#
#...B.B##.B.#.##...#
#.....B........#...#
#...B.B.BB###BB#...#
#.B..B#...#...B..B.#
#.BB###B#.B.B#BB#..#
#...S.#.BB.....#BB.#
#.#.#.#.B#B.#.B.BB.#
#..................#
####################
