####################
#..................#
#.B.BB#BBBB##.#.BB.#
#.#.#..B.B....#..B.#
#.#.B.#BBB#BB.#.#B.#
#.....#B#.#..#.#...#
#...B.#.#BB.####...#
#....#..#..B.......#
#...###B##B#B.B....#
#.#.S......#....#S.#
#.B.B.#.##BSB.#.##.#
#..#.....B#......B.#
#.#.#.B.BB##B.B.#..#
#..................#
####################
