####################
#..............S...#
#.#.##B.#BB.B.B##..#
#....#B..BB##...B..#
#.B.####B###B#B.#B.#
#...#.S...B.#......#
#...#BB.#.###.#....#
#..S.#.#.B.BB...S..#
#...B.B##.B.##B....#
#..B.#.....B#....#.#
#.B.#.#.#BB.BB#B##.#
#..##..###..#BB.#B.#
#.B.#.#.#.#.#.##BS.#
#..S...............#
####################
